....................
....................
....................
....................
....................
....................
....................
...........CCC......
...........###.....
......CCC...........
......###.......CCC.
................###.
.###................
....................
#######################################
